1111111111111
1000000000001
100001000P001
1000000111111
100000000E0C1
1111111111111