1111111111111
1C10000000001
100001000P001
1000000111111
1000000C0E001
1111111111111