2111111111111
10000A000001
10000B0000001
1000P00000001
100000000E0C1
1111111111112