1111111111111
1000000000001
10P0010000001
1000000000001
100000100E0C1
1111111111111