111111111
1P000C001
1P0E0C001
111111111