1111111111111111111111
1000000000000000000001
1000000000000000000001
1000000000000000000001
1000000000000000000001
1P0E000000000000000001
1000000111000000000001
1000000100000000000001
1000000100000000000001
10000001C00000000C0001
1111111111111111111111