1111111111111111
1000000000000001
1000000000000001
1000000000000001
1000000000000001
1P0E0C0000000001
1000000111000001
1000000000000001
1000000000000001
1000000000000001
1111111111111111