1111111111111
1000000000001
100000000r001
1000000000001
100000000E0C1
1111111111111