1111111111111
1P00000000001
1000000000001
10000C0000011
10000000001E1
1111111111111